0 0 0 0 0 0 0 0 0 0 0 0 0 0 0 
0 0 0 0 0 0 0 0 0 0 0 0 0 0 0 
0 0 1 5 5 5 5 0 5 5 5 5 5 5 0 
0 0 1 5 5 5 5 0 5 5 5 5 5 5 0 
0 0 1 5 5 5 5 0 5 5 5 5 5 5 0 
0 0 1 5 5 5 5 0 5 5 5 5 5 5 0 
0 0 1 0 0 0 0 0 5 5 5 5 5 5 0 
0 0 1 0 0 0 0 0 7 0 0 0 0 0 0 
0 0 1 0 0 0 0 0 7 0 0 0 0 0 0 
0 0 1 0 0 0 0 0 7 0 0 0 0 0 0 
